BRL = "countries/Berlin_Zone.txt"
ZNE = "countries/Zentral_europe.txt"
PUS = "countries/RIP_Pruss.txt"
MAR = "countries/Mari.txt"

GWF = "countries/Werewolfs.txt"
GRA = "countries/Red Army.txt"
GSU = "countries/Sudeten.txt"

GSV = "countries/Free Slovakia.txt"
GCZ = "countries/Czechia.txt"
GRH = "countries/Rheinish Union.txt"
GSI = "countries/Free Silesia.txt"
GBW = "countries/Baden-Wuttemberg.txt"
GBV = "countries/Free Bavaria.txt"
GAU = "countries/Free Austria.txt"
GDN = "countries/Free Denmark.txt"
GHL = "countries/Free Holland.txt"
GNR = "countries/Free Norway.txt"
GWS = "countries/Westphalian Federation.txt"
GPL = "countries/Free Poland.txt"
GFR = "countries/Free GFrance.txt"
GSG = "countries/South German Fed.txt"
XYZ = "countries/South German Fed.txt"
GEX = "countries/German Exiles.txt"

HAN = "countries/Han Front.txt"
PFF = "countries/Primorie.txt"
MJP = "countries/JPN Manchuko.txt"

MTR = "countries/Turkestan.txt"
MBP = "countries/Berezniki Baltics.txt"
MBL = "countries/Berezniki Belarus.txt"
MUK = "countries/Berezniki Ukraine.txt"
MCS = "countries/Berezniki Caucausus.txt"
MTV = "countries/Berezniki Taurida.txt"

CHY = "countries/Chechnya.txt"
DGS = "countries/Dagestan.txt"
OSS = "countries/Osetia.txt"
KRC = "countries/Karachay.txt"
KBR = "countries/Kabardino-Balkaria.txt"
ABZ = "countries/Abkhazia.txt"